portal:bible/featured chapter/deuteronomy 13 -> kumashiro
cd cinfães -> hanjan, kerman
virginia state route 754 -> controversial pseudosciences
uronema -> sessegnon
betty hahn bernbaum -> draft:kamo shrine (sakaide city)
edgardo saporetti -> rensi
world orienteering championships -> erwina lilia rys-ferens
3 skypephone series -> 2013–14 manchester united football club season
draft:kamo shrine (nagano city nishinagano) -> winsten
geisa aparecida coutinho -> rowley, samuel
carles juanmartí -> tradex
redkite (organisation) -> executive branch reform act
hms woodcock (u90) -> gen. woodford
cemilli kalesi -> kent (ny)
jukebox junkie -> euhalisidota otho
katherine bitting -> list of mysims characters
corea sea -> baurus
the adventures of greyfriars bobby -> witchell, henry
1957 richmond by-election -> u+0149
michael hawley -> mary agee
m202 flash -> moodna
the book of us: gluon -> nałęcz (disambiguation)
act music -> pearson, steven
omar kamal -> lake whitaker
gen. bower -> article 16
list of crossings of the youghiogheny river -> uni5, the world's enemy
pachnephorus achardi -> anne marie cox
1965 brownlow medal -> ckgn
antonio weck -> state route 468
ernesto montagne markholz -> levitin, daniel
michael lonsdale -> soberlak, peter
module:location map/data/chile chiloé -> orbital nodes
buchberg -> mark boyd
lee jun-hyuk (footballer) -> list of public art in roswell, georgia
fungi in art -> dweep (disambiguation)
colin mackay (journalist) -> 1967–68 huddersfield town afc season
nanobagrus -> john f. barros
luarts lame -> crayne
michael urie -> schultz lake
andrew barentsen house -> robert daniels (disambiguation)
2006 fis ski jumping grand prix -> california star (disambiguation)
shanelle nyasiase -> murray french
tarache major -> sir william robert grove
gurps bili the axe – up harzburk! -> beisel-mitchell house
us open plant breeding and crop science journal -> st. laurent-class destroyer
natural history (j. d. souther album) -> opera (disambiguation)
2009 solheim cup -> draft:bebashi
shark bay -> aerfort phort láirge
freddie green (footballer) -> johnny reb (disambiguation)
list of international trips made by prime ministers of the united kingdom -> 2012-13 tampa bay lightning
burgie castle -> pointe coupée conspiracy
skop -> nettleton, william
guillaume ormond -> bobrovcek
d60 road -> portal:battleships/selected picture/6
bademağacı, antalya -> oyster bay - east norwich central school district
boris diecket -> pontonous
shirdley hill railway station -> battle of the cumberland gap
eliza healy -> polycyclic musks
italian submarine jalea -> timedtext:hopsin - ill mind of hopsin 4.ogg.en.srt
müritzarm -> cardinal navarrete cortés
guenther, charles -> 1996 college football all–american team
list of ambassadors of albania to russia -> healy, mark
circa nieuport 17 -> world open savings &amp; development journal
villisca community school district -> starkey, ny
portal:london transport/anniversaries/24 june -> volkovo, vashkinsky district, vologda oblast
roger browne (priest) -> dittus
farm to market road 470 -> crossing sequence
nudaria idalis -> print services for unix
barrow gravel pits -> gravett
fix (blackstreet song) -> list of israeli films of 2000
gulielma penn -> prospect park station (pennsylvania)
2016–17 new mexico state aggies men's basketball team -> hillel yaffe hospital
ioan barou -> 79th regiment of foot (disambiguation)
republic of the congo - us relations -> triple-u
